Mariota comes off bench , Titans beat Jaguars 9 - 6	0,7,PLAYER;26,32,TEAM;38,45,TEAM
JACKSONVILLE , Fla. ( AP ) Marcus Mariota just has a knack for beating Jacksonville .	0,12,CITY;15,19,STATE;22,24,ORG;27,41,PLAYER;71,83,TEAM
He 's done it with his arm . He 's done it with his legs . Now he 's done it off the bench .
Mariota directed three scoring drives in relief of Blaine Gabbert , including one in the fourth quarter , and Tennessee knocked off the Jaguars 9 - 6 Sunday for their third straight victory in the series . Mariota improved to 5 - 2 against Jacksonville , his most wins against any opponent .	0,7,PLAYER;51,65,PLAYER;110,119,TEAM;136,143,TEAM;150,156,DATETIME;206,213,PLAYER;240,252,TEAM
First - year Titans coach Mike Vrabel gave Mariota a game ball in the locker room .	13,19,TEAM;26,27,BOSS;43,50,PLAYER
' ' He was fantastic , '' Vrabel said . ' ' He cares about this team immensely . He wants what 's best for this team . You saw him come in there , get us some first downs and give us a spark . ''	26,32,BOSS
Mariota sat out last week 's victory against Houston because of an elbow injury sustained in the season opener . He was still experiencing arm weakness along with numbness and tingling in two fingers this week , saying the injury affects the velocity and spin he gets on the football .	0,7,PLAYER
Mariota , who wore a glove on his injured right hand , replaced Gabbert ( concussion ) in the first quarter and did just enough to beat the Jaguars ( 2 - 1 ) for the fifth time in the past six meetings .	0,7,PLAYER;64,71,PLAYER;140,147,TEAM
Mariota completed 12 of 18 passes for 100 yards and ran for 51 more , including a 15-yard gain on a third - and-1 play late . The Titans ( 2 - 1 ) milked the clock from there and ended up celebrating an early lead in the AFC South .	0,7,PLAYER;130,136,TEAM;221,230,ORG
' ' Jacksonville has been favored over us these last couple of games because people look at papers ; they do n't pay attention to how we play , '' Titans defensive tackle Jurrell Casey said .	4,16,TEAM;147,153,TEAM;171,184,PLAYER
' ' They walk into this game thinking they 've got it , and we know what we can do on our side of the field and we make sure we do it all four quarters . Do n't let them get ahead of you and we can play with these guys . ''
Tennessee finished with 2	0,9,TEAM
' ' We 're not afraid of anyone , '' Titans left tackle Taylor Lewan said . ' ' We 're going to play as if we belong anywhere . People will count us out , but that 's not the case . ''	37,43,TEAM;56,68,PLAYER
Jacksonville looked lost most of the afternoon on one side of the ball , failing to score an offensive touchdown against Tennessee for the second time in as many games .	0,12,TEAM;121,130,TEAM
Tennessee took away big passing plays , kept a spy on Bortles and dared Jacksonville to win with two backup offensive linemen and a backup running back .	0,9,TEAM;54,61,PLAYER;72,84,TEAM
Playing without running back Leonard Fournette , left tackle Cam Robinson and right guard A.J. Cann , the Jags managed 232 yards and a measly 12 first downs . Poor throws , dropped passes and eight penalties hurt . So did coach Doug Marrone 's decision to try a fake punt early in the game .	29,46,PLAYER;61,73,PLAYER;90,99,PLAYER;106,110,TEAM;228,240,BOSS
Corey Grant was stopped on the fourth - and-4 play , giving Tennessee the ball near midfield and leading to Ryan Succop 's first field goal .	0,11,PLAYER;60,69,TEAM;108,119,PLAYER
' ' I always regret decisions that do n't work , '' Marrone said . ' ' I just wanted to be aggressive early and had the look . ''	52,59,BOSS
Jacksonville never found an offensive rhythm , looking much more like the team that struggled in the opener at the New York Giants than the one that shined last week against New England .	0,12,TEAM;115,130,TEAM;174,185,TEAM
' ' We 've got to not hurt ourselves , especially the way our defense is and the way we play , '' Bortles said . ' ' We 've got to score one touchdown to win the game . To go out there and score six points in four quarters , that 's bad as an offense .	98,105,PLAYER
' ' We 've got to find out and figure out how we 're going to handle it as a team . ''
STICKING TOGETHER
The Jaguars insist there was no finger - pointing after the game , even though it was clear the loss was on the offense .	4,11,TEAM
Linebacker Telvin Smith even blamed the defense , saying ' ' we say we 're the best ; we 've got to go out and be the best . ''	11,23,PLAYER
NO FOURNETTE	3,12,PLAYER
Fournette missed his second straight game because of a strained right hamstring . Jacksonville ran for 87 yards and lost for the first time in five games without him .	0,9,PLAYER;82,94,TEAM
KEY INJURIES
Titans punt returner Adoree ' Jackson joined Gabbert in the locker room in the second quarter and was later ruled out with a concussion . ... Titans LB Jayon Brown got hurt late in the game but jogged off the field .	0,6,TEAM;21,37,PLAYER;45,52,PLAYER;142,148,TEAM;152,163,PLAYER
Jaguars defensive end Calais Campbell left the game in the fourth quarter with a right ankle injury . He had his ankle and his right knee wrapped in ice after the game . Defensive tackle Marcell Dareus left briefly in the second half with a shoulder injury .	0,7,TEAM;22,37,PLAYER;187,201,PLAYER
UP NEXT
Titans return home to take on defending Super Bowl champion Philadelphia next Sunday .	0,6,TEAM;40,50,GAME;60,72,TEAM;78,84,DATETIME
Jaguars complete a three - game homestand against the New York Jets next Sunday .	0,7,TEAM;54,67,TEAM;73,79,DATETIME
